You wake up on the deck of a medium sized boat. You don't see your captor, but he's either close or has left you here to die. You need to get off this boat.

Mini Game (Boat)
An Interactive Fiction by bscott19
Release 1 / Serial number 190213 / Inform 7 build 6M62 (I6/v6.33 lib 6/12N) SD

Deck
You are on a small boat deck. There are sails and fuel and pumps at the bow, a staircase leading down on the starbord side, and a small powered raft at the stern. Many nooks and crannies for things to be hidden. There is blue ocean for days in all directions.

Be sure to have proper supplies to be at sea for days before you find shore. Hint there may be a leak in the raft, find a way to keep water out too.

>down
Galley
You are now in the hull of the boat. At the base of the stairs there is a bed, small office area, and kitchen, all in a studio layout.

On Desk is Note.

>examine
What do you want to examine?

>examine galley
You can't see any such thing.

>examine Galley
You can't see any such thing.

>examine Filing cabinet
You see nothing special about Filing cabinet.

* * *

>down
Galley
You are now in the hull of the boat. At the base of the stairs there is a bed, small office area, and kitchen, all in a studio layout.

On Desk is Note.

>examine filing cabinet
There is a single drawer in this filing cabinet, and it doesn't appear to be locked.

>open drawer
You can't see any such thing.

>open filing cabinet
You open Filing cabinet.

* * *

>down
Galley
You are now in the hull of the boat. At the base of the stairs there is a bed, small office area, and kitchen, all in a studio layout.

On Desk is Note.

>open filing cabinet
You open Filing cabinet, revealing Raft key.

>examine raft key
Regular sized key that says OCEAN EXPLORER on it. You think that was the name of the small raft up on the deck

>Take raft key
Taken.

* * *

>enter escape raft
You get into Escape Raft.

* * *

>x sails
You can't see any such thing.

>x raft
You see nothing special about Escape Raft.

>d
Galley
You are now in the hull of the boat. At the base of the stairs there is a bed, small office area, and kitchen, all in a studio layout. The Deck is upstairs

On the Desk is Note.

>x note
You see nothing special about Note.

>read note
You see nothing special about Note.

>take note
Taken.

>x desk
You see nothing special about the Desk.

>x kitchen
You can't see any such thing.

>x bed
You can't see any such thing.

>x filing cabinet
There is a single drawer in this filing cabinet, and it doesn't appear to be locked.

>open cabinet
You open Filing cabinet, revealing Key.

>x key
Regular sized key that says OCEAN EXPLORER on it. You think that was the name of the small raft up on the deck.

>take key
Taken.

>x pantry
Large pantry with plenty of non-perishable food to keep you fed on a journey. Too bad it's bolted shut.

>unlock pantry with key
That doesn't seem to be something you can unlock.

>open pantry
You open Pantry, revealing Granola Bars, Water Flask and Can of Green Beans.

>take all
Granola Bars: Taken.
Water Flask: Taken.
Can of Green Beans: Taken.

>u
Deck
You are on a small boat deck. There are sails and fuel and pumps at the bow, a staircase leading down on the starbord side, and a small powered raft at the stern. Many nooks and crannies for things to be hidden. There is blue ocean for days in all directions.

Be sure to have proper supplies to be at sea for days before you find shore. Hint there may be a leak in the raft, find a way to keep water out too.

>get in raft
You can't get into the closed Escape Raft.

>open raft
Putting key in ignition

>enter raft
You get into Escape Raft.